NO assets/texturas/color_marble.xpm
SO assets/texturas/color_wall.xpm
WE assets/texturas/rough_wall.xpm
EA assets/texturas/rough_wall.xpm

F 10,12,15
C 45,50,60


111111111111111111111111111111111
100000000000000100000000000000001
101111111111110101111111111111101
101000000000000100000000000000101
101011111111101110111111111110101
101010000000100000100000000010101
101010111110101110101111111010101
101010100010101010101000001010101
101010101010101010101011101010101
101000101010000000001010101000101
101111101011111011111010101111101
100000001000000000000010100000001
101111111111111011111110111111101
101000000000001010000000000000101
101011111111101010111111111110101
101000000000001010000000000000101
101111111111111011111111111111101
100000000000000N00000000000000001
111111111111111111111111111111111
